Blue-eyes White Dragon
Mystical Elf	Elf	Female	Spellcaster
Hitotsu-me Giant	Fiend Summon
Baby Dragon	Dragon
Ryu-kishin	Fiend
Feral Imp	Fiend	Fiend Summon
Winged Dragon #1	Dragon
Mushroom Man	Plant
Shadow Specter	Fiend Summon	Zombie
Blackland Fire Dragon	Dragon	Shadow
Sword Arm of Dragon	Dinosaur	Dragon
Swamp Battleguard	Shadow	Warrior
Tyhone	Winged Beast
Battle Steer
Flame Swordsman	Pyro	Warrior
Time Wizard	Spellcaster
Right Leg of the Forbidden One	Dark Spellcaster	Shadow	Spellcaster
Left Leg of the Forbidden One	Dark Spellcaster	Shadow	Spellcaster
Right Arm of the Forbidden One	Dark Spellcaster	Shadow	Spellcaster
Left Arm of the Forbidden One	Dark Spellcaster	Shadow	Spellcaster
Exodia the Forbidden	Dark Spellcaster	Shadow	Spellcaster
Summoned Skull
The Wicked Worm Beast	Beast
Skull Servant	Fiend Summon	Zombie
Horn Imp	Fiend	Fiend Summon
Battle Ox
Beaver Warrior
Rock Ogre Grotto #1	Rock
Mountain Warrior
Zombie Warrior	Zombie
Koumori Dragon	Dragon
Two-headed King Rex	Dinosaur
Judge Man
Saggi the Dark Clown	Dark Spellcaster	Shadow	Spellcaster
Dark Magician
The Snake Hair	Zombie
Gaia the Dragon Champion	Dragon
Gaia the Fierce Knight
Curse of Dragon	Dragon
Dragon Piper	Jar	Pyro
Celtic Guardian	Elf	Light	Warrior
Illusionist Faceless Mage	Spellcaster
Karbonala Warrior	Warrior
Rogue Doll	Light	Spellcaster
Oscillo Hero #2	Thunder
Griffore	Animal	Beast
Torike	Animal	Beast
Sangan	Fiend	Fiend Summon
Big Insect	Insect
Basic Insect	Insect
Armored Lizard	Neptune	Reptile
Hercules Beetle	Insect
Killer Needle	Insect
Gokibore	Insect
Giant Flea	Insect
Larvae Moth	Insect
Great Moth
Kuriboh	Fiend	Fiend Summon
Mammoth Graveyard	Dinosaur	Fiend Summon
Great White	Fish	Neptune
Wolf	Animal	Beast
Harpie Lady	Feathered A	Feathered B	Female	Harpie	Harpie Killer	Winged Beast
Harpie Lady Sisters	Feathered A	Feathered B	Female	Harpie	Harpie Killer	Winged Beast
Tiger Axe
Silver Fang	Animal	Beast
Kojikocy	Warrior
Perfectly Ultimate Great Moth
Garoozis	Pyro
Thousand Dragon	Dragon
Fiend Kraken	Aqua	Neptune
Jellyfish	Aqua	Neptune
Cocoon of Evolution	Insect
Kairyu-shin	Dragon	Neptune
Giant Soldier of Stone	Rock
Man-eating Plant	Plant
Krokodilus	Neptune	Reptile
Grappler	Neptune	Reptile
Axe Raider	Warrior
Megazowler
Uraby	Dinosaur
Crawling Dragon #2	Dinosaur	Dragon
Red-eyes B. Dragon	Dragon
Castle of Dark Illusions	Fiend	Shadow
Reaper of the Cards	Fiend	Fiend Summon
King of Yamimakai	Fiend
Barox	Fiend
Dark Chimera	Fiend
Metal Guardian	Fiend	Fiend Summon
Catapult Turtle	Aqua	Neptune	Turtle
Gyakutenno Megami	Female
Mystic Horseman	Animal	Beast
Rabid Horseman
Zanki	Warrior
Crawling Dragon	Dragon
Crass Clown	Fiend
Armored Zombie	Zombie
Dragon Zombie	Dragon	Zombie
Clown Zombie	Zombie
Pumpking the King of Ghosts	Zombie
Battle Warrior	Warrior
Wings of Wicked Flame	Pyro
Mask of Darkness	Fiend	Shadow
Job-change Mirror	Fiend	Mirror	Shadow
Curtain of the Dark Ones	Dark Spellcaster	Shadow	Spellcaster
Tomozaurus	Dinosaur
Spirit of the Winds	Spellcaster
Kageningen	Fiend Summon	Warrior
Graveyard and the Hand of Invitation	Fiend Summon	Zombie
Goddess with the Third Eye	Fairy	Female	Light
Hero of the East	Warrior
Doma The Angel of Silence	Fairy	Shadow
That Which Feeds on Life	Fiend	Shadow
Dark Gray	Animal	Beast
White Magical Hat	Light	Spellcaster
Kamion Wizard	Dark Spellcaster	Shadow	Spellcaster
Nightmare Scorpion	Insect
Spirit of the Books	Winged Beast
Supporter in the Shadows	Warrior
Trial of Nightmares	Fiend	Fiend Summon
Dream Clown	Warrior
Sleeping Lion	Animal	Beast
Yamatano Dragon Scroll	Dragon
Dark Plant	Plant
Ancient Tool	Machine
Faith Bird	Feathered A	Feathered B	Light	Winged Beast
Orion the Battle King
Ansatsu	Shadow	Warrior
LaMoon	Feathered A	Feathered B	Female	Light	Spellcaster	Winged
Nemuriko	Dark Spellcaster	Female	Shadow	Spellcaster
Weather Control	Fairy	Light
Octoberser	Aqua	Neptune
The 13th Grave	Zombie
Charubin the Fire Knight	Pyro
Mystical Capture Chain	Fairy	Light
Fiend's Hand	Fiend Summon	Zombie
Witty Phantom	Fiend	Shadow
Mystery Hand	Fiend	Fiend Summon
Dragon Statue	Dragon	Warrior
Blue-eyed Silver Zombie	Fiend Summon	Zombie
Toad Master	Aqua	Neptune
Spiked Snail	Fiend Summon	Insect
Flame Manipulator	Pyro	Spellcaster
Necrolancer the Timelord	Spellcaster
Djinn the Watcher of the Wind	Spellcaster
The Bewitching Phantom Thief	Spellcaster
Temple of Skulls	Shadow	Zombie
Monster Egg	Egg	Warrior
The Shadow Who Controls the Dark	Fiend	Shadow
Lord of the Lamp	Fiend	Shadow
Akihiron	Aqua	Neptune
Rhaimundos of the Red Sword	Neptune	Warrior
The Melting Red Shadow	Aqua	Fiend Summon
Dokuroizo the Grim Reaper	Fiend Summon	Zombie
Fire Reaper	Pyro	Zombie
Larvas	Beast
Hard Armor	Warrior
Firegrass	Plant	Pyro
Man Eater	Plant
Dig Beak	Beast
M-warrior #1	Warrior
M-warrior #2	Warrior
Tainted Wisdom	Fiend	Fiend Summon
Lisark	Beast	Feathered A	Feathered B
Lord of Zemia	Fiend	Shadow
The Judgement Hand	Light	Warrior
Mysterious Puppeteer	Warrior
Ancient Jar	Jar	Rock
Darkfire Dragon	Dragon	Pyro
Dark King of the Abyss	Fiend	Shadow
Spirit of the Harp	Fairy	Light
Big Eye	Fiend
Armaill	Pyro	Warrior
Dark Prisoner	Fiend	Shadow
Hurricail	Spellcaster
Ancient Brain	Fiend	Shadow	Winged
Fire Eye	Pyro
Monsturtle	Aqua	Neptune	Turtle
Claw Reacher	Fiend	Shadow
Phantom Dewan	Dark Spellcaster	Shadow	Spellcaster
Arlownay	Female	Plant
Dark Shade	Fiend
Masked Clown	Shadow	Warrior
Lucky Trinket	Light	Spellcaster
Genin	Spellcaster
Eyearmor	Warrior
Fiend Refrection #2	Feathered B	Mirror	Winged Beast
Gate Deeg	Beast	Fiend Summon
Synchar	Animal	Beast
Fusionist	Animal	Beast	Feathered A	Feathered B	Winged
Akakieisu	Dark Spellcaster	Shadow	Spellcaster
LaLa Li-oon	Thunder
Key Mace	Fairy	Female	Light
Turtle Tiger	Aqua	Neptune	Turtle
Terra the Terrible	Fiend	Fiend Summon
Doron	Neptune	Warrior
Arma Knight	Aqua	Neptune
Mech Mole Zombie	Fiend Summon	Zombie
Happy Lover	Fairy	Feathered A	Feathered B	Light	Winged
Penguin Knight	Aqua
Petit Dragon	Dragon
Frenzied Panda	Animal	Beast
Air Marmot of Nefariousness	Animal	Beast	Fiend Summon
Phantom Ghost	Fiend Summon	Zombie
Mabarrel	Fiend
Dorover	Aqua	Neptune
Twin Long Rods #1	Aqua	Fiend Summon
Droll Bird	Winged Beast
Petit Angel	Fairy	Light	Winged
Winged Cleaver	Insect
Hinotama Soul	Pyro
Kaminarikozou	Thunder
Meotoko	Beast	Fiend Summon
Aqua Madoor	Neptune	Spellcaster
Kagemusha of the Blue Flame	Pyro	Warrior
Flame Ghost	Pyro	Zombie
Dryad	Female	Spellcaster
B. Skull Dragon
Two-mouth Darkruler	Dinosaur	Fiend Summon
Solitude	Fiend Summon
Masked Sorcerer	Dark Spellcaster	Shadow	Spellcaster
Kumootoko	Insect
Midnight Fiend	Fiend	Fiend Summon
Roaring Ocean Snake
Trap Master	Shadow	Warrior
Fiend Sword	Warrior
Skull Stalker	Fiend Summon	Warrior
Hitodenchak	Aqua	Neptune
Wood Remains	Zombie
Hourglass of Life	Fairy	Feathered A	Feathered B	Light	Winged
Rare Fish	Fish	Neptune
Wood Clown	Shadow	Warrior
Madjinn Gunn	Fiend	Fiend Summon
Dark Titan of Terror	Fiend	Shadow
Beautiful Headhuntress	Female	Shadow	Warrior
Wodan the Resident of the Forest	Warrior
Guardian of the Labyrinth	Shadow	Warrior
Haniwa	Rock
Yashinoki	Plant
Vishwar Randi	Female	Shadow	Warrior
The Drdek	Fiend	Fiend Summon
Dark Assailant	Zombie
Candle of Fate	Fiend	Pyro
Water Element	Aqua	Female	Neptune
Dissolverock	Pyro	Rock
Meda Bat	Fiend	Fiend Summon
One Who Hunts Souls	Fiend Summon
Root Water	Fish	Neptune
Master & Expert	Animal	Beast
Water Omotics	Aqua	Female	Neptune
Hyo	Neptune	Warrior
Enchanting Mermaid	Female	Fish	Neptune
Nekogal #1	Beast	Female
Angelwitch	Dark Spellcaster	Feathered A	Feathered B	Female	Shadow	Spellcaster	Winged
Embryonic Beast	Fiend	Fiend Summon
Prevent Rat	Animal	Beast
Dimensional Warrior	Warrior
Stone Armadiller	Rock
Beastking of the Swamps	Aqua
Ancient Sorcerer	Dark Spellcaster	Shadow	Spellcaster
Lunar Queen Elzaim	Fairy	Female	Light	Winged
Wicked Mirror	Fiend	Mirror
The Little Swordsman of Aile	Neptune	Warrior
Rock Ogre Grotto #2	Rock
Wing Egg Elf	Egg	Elf	Fairy	Feathered A	Feathered B	Light	Winged
The Furious Sea King	Aqua	Neptune
Princess of Tsurugi	Female	Warrior
Unknown Warrior of Fiend	Shadow	Warrior
Sectarian of Secrets	Dark Spellcaster	Shadow	Spellcaster
Versago the Destroyer	Fiend	Shadow
Wetha	Aqua	Neptune
Megirus Light	Fiend	Shadow
Mavelus	Feathered A	Feathered B	Pyro	Winged Beast
Ancient Tree of Enlightenment	Plant
Green Phantom King	Plant
Ground Attacker Bugroth	Machine
Ray & Temperature	Fairy
Gorgon Egg	Egg	Fiend	Fiend Summon
Petit Moth	Insect
King Fog	Fiend	Shadow
Protector of the Throne	Female	Warrior
Mystic Clown	Fiend	Shadow
Mystical Sheep #2	Animal	Beast
Holograh	Machine
Tao the Chanter	Spellcaster
Serpent Marauder	Neptune	Reptile
Gatekeeper	Machine	Shadow
Ogre of the Black Shadow	Fiend Summon
Dark Artist	Fiend	Shadow
Change Slime	Aqua	Neptune
Moon Envoy	Light	Warrior
Fireyarou	Pyro
Psychic Kappa	Aqua	Neptune
Masaki the Legendary Swordsman	Light	Warrior
Dragoness the Wicked Knight	Warrior
Bio Plant	Fiend
One-eyed Shield Dragon	Dragon
Cyber Soldier of Darkworld	Machine
Wicked Dragon with the Ersatz Head	Dragon	Fiend Summon
Sonic Maid	Female	Light	Warrior
Kurama	Winged Beast
Legendary Sword
Sword of Dark Destruction
Dark Energy
Axe of Despair
Laser Cannon Armor
Insect Armor with Laser Cannon
Elf's Light
Beast Fangs
Steel Shell
Vile Germs
Black Pendant
Silver Bow and Arrow
Horn of Light
Horn of the Unicorn
Dragon Treasure
Electro-whip
Cyber Shield
Elegant Egotist
Mystical Moon
Stop Defense
Malevolent Nuzzler
Violet Crystal
Book of Secret Arts
Invigoration
Machine Conversion Factory	Harpie Killer
Raise Body Heat
Follow Wind	Feathered B
Power of Kaishin
Dragon Capture Jar
Forest
Wasteland
Mountain
Sogen
Umi
Yami
Dark Hole
Raigeki
Mooyan Curry
Red Medicine
Goblin's Secret Remedy
Soul of the Pure
Dian Keto the Cure Master
Sparks
Hinotama
Final Flame
Ookazi
Tremendous Fire
Swords of Revealing Light
Spellbinding Circle
Dark-piercing Light
Yaranzo	Zombie
Kanan the Swordmistress	Female	Warrior
Takriminos	Dragon	Neptune
Stuffed Animal	Fiend Summon	Warrior
Megasonic Eye	Machine
Super War-lion
Yamadron	Dragon	Pyro
Seiyaryu	Dragon
Three-legged Zombies	Fiend Summon	Zombie
Zera The Mant
Flying Penguin	Aqua	Feathered B	Neptune
Millennium Shield	Warrior
Fairy's Gift	Female	Spellcaster
Black Luster Soldier
Fiend's Mirror	Fiend
Labyrinth Wall	Rock
Jirai Gumo
Shadow Ghoul	Zombie
Wall Shadow	Warrior
Labyrinth Tank
Sanga of the Thunder	Thunder
Kazejin
Suijin
Gate Guardian
Dungeon Worm	Insect
Monster Tamer	Warrior
Ryu-kishin Powered	Fiend
Swordstalker	Warrior
La Jinn the Mystical Genie	Fiend	Shadow
Blue-eyes Ultimate Dragon
Toon Alligator	Neptune	Reptile
Rude Kaiser
Parrot Dragon	Dragon
Dark Rabbit	Beast	Fiend Summon
Bickuribox	Fiend
Harpie's Pet Dragon	Dragon
Mystic Lamp	Dark Spellcaster	Shadow	Spellcaster
Pendulum Machine	Machine	Shadow
Giltia the D. Knight	Warrior
Launcher Spider	Pyro
Zoa
Metalzoa
Zone Eater	Aqua	Neptune
Steel Scorpion	Machine
Dancing Elf	Elf	Fairy	Female	Winged
Ocubeam	Fairy	Winged
Leghul	Insect
Ooguchi	Aqua	Neptune
Swordsman from a Foreign Land	Warrior
Emperor of the Land and Sea	Neptune	Reptile
Ushi Oni	Fiend
Monster Eye	Fiend	Fiend Summon
Leogun	Animal	Beast
Tatsunootoshigo	Beast	Neptune
Saber Slasher	Machine
Yaiba Robo	Machine
Machine King	Pyro
Giant Mech-soldier	Machine
Metal Dragon	Dragon	Pyro
Mechanical Spider	Machine
Bat	Machine
Giga-tech Wolf	Machine
Cyber Soldier	Machine
Shovel Crusher	Machine
Mechanicalchacer
Blocker	Machine
Blast Juggler	Machine	Pyro
Golgoil	Machine
Giganto	Machine
Cyber-Stein	Machine
Cyber Commander	Machine
Jinzo #7	Machine
Dice Armadillo	Machine
Sky Dragon	Dragon	Feathered B
Thunder Dragon	Dragon	Thunder
Stone D.	Dragon	Rock
Kaiser Dragon	Dragon
Magician of Faith	Female	Light	Spellcaster
Goddess of Whim	Fairy	Female	Light
Water Magician	Aqua	Female	Neptune
Ice Water	Aqua	Female	Neptune
Waterdragon Fairy	Aqua	Female	Neptune
Ancient Elf	Elf	Female	Light	Spellcaster
Beautiful Beast Trainer	Female	Warrior
Water Girl	Aqua	Female	Neptune
White Dolphin	Fish	Neptune
Deepsea Shark
Metal Fish	Machine	Neptune
Bottom Dweller	Fish	Neptune
7 Colored Fish	Neptune
Mech Bass	Machine	Neptune
Aqua Dragon	Dragon
Sea King Dragon	Dragon
Turu-Purun	Aqua	Neptune
Guardian of the Sea	Aqua	Neptune
Aqua Snake	Aqua	Neptune
Giant Red Seasnake	Aqua	Neptune
Spike Seadra	Dragon
30,000-Year White Turtle	Aqua	Neptune	Turtle
Kappa Avenger	Aqua	Neptune
Kanikabuto	Aqua	Neptune
Zarigun	Aqua	Neptune
Millennium Golem	Rock
Destroyer Golem	Rock
Barrel Rock	Rock
Minomushi Warrior	Rock
Stone Ghost	Rock
Kaminari Attack	Thunder
Tripwire Beast	Thunder
Bolt Escargot	Thunder
Bolt Penguin	Thunder
The Immortal of Thunder	Thunder
Electric Snake	Thunder
Wing Eagle	Feathered A	Feathered B	Winged Beast
Punished Eagle	Feathered A	Feathered B	Winged Beast
Skull Red Bird	Feathered A	Feathered B	Winged Beast
Crimson Sunbird	Feathered B
Queen Bird	Feathered A	Feathered B	Winged Beast
Armed Ninja	Neptune	Warrior
Magical Ghost	Zombie
Soul Hunter	Fiend
Air Eater	Fiend
Vermillion Sparrow	Pyro
Sea Kamen	Aqua	Neptune
Sinister Serpent	Neptune	Reptile
Ganigumo	Insect
Alinsection	Insect
Insect Soldiers of the Sky	Insect
Cockroach Knight	Insect
Kuwagata a	Insect
Burglar	Animal	Beast
Pragtical
Garvas	Animal
Ameba	Aqua	Neptune
Korogashi	Insect
Boo Koo	Light	Spellcaster
Flower Wolf	Animal	Beast
Rainbow Flower	Plant	Rainbow
Barrel Lily	Plant
Needle Ball	Fiend	Fiend Summon
Peacock	Feathered A	Feathered B	Winged Beast
Hoshiningen	Fairy	Light	Rainbow
Maha Vailo	Light	Spellcaster
Rainbow Marine Mermaid	Female	Fish	Neptune	Rainbow
Musician King	Spellcaster
Wilmee	Beast
Yado Karu	Aqua	Neptune
Morinphen	Fiend
Kattapillar	Insect
Dragon Seeker	Fiend
Man-eater Bug	Insect
D. Human	Warrior
Turtle Raccoon	Aqua	Turtle
Fungi of the Musk	Fiend
Prisman	Rock
Gale Dogra	Insect
Crazy Fish	Fish	Neptune
Cyber Saurus	Machine
Bracchio-raidus
Laughing Flower	Plant
Bean Soldier	Plant
Cannon Soldier	Machine
Guardian of the Throne Room	Light	Machine
Brave Scizzar	Machine
The Statue of Easter Island	Rock
Muka Muka	Rock
Sand Stone	Rock
Boulder Tortoise	Aqua	Turtle
Fire Kraken	Aqua	Pyro
Turtle Bird	Turtle
Skullbird	Winged Beast
Monstrous Bird	Feathered A	Feathered B	Winged Beast
The Bistro Butcher	Fiend
Star Boy	Aqua	Neptune
Spirit of the Mountain	Spellcaster
Neck Hunter	Fiend
Milus Radiant	Animal	Beast
Togex	Animal	Beast
Flame Cerebrus
Eldeen	Dark Spellcaster	Female	Shadow	Spellcaster
Mystical Sand
Gemini Elf	Elf	Female
Kwagar Hercules
Minar	Fiend Summon	Insect
Kamakiriman	Insect
Mechaleon	Neptune	Reptile
Mega Thunderball	Thunder
Niwatori	Winged Beast
Corroding Shark	Fiend Summon	Zombie
Skelengel	Fairy	Feathered B	Light	Winged
Hane-Hane	Beast	Feathered B
Misairuzame	Fish	Neptune
Tongyo	Fish	Neptune
Dharma Cannon	Machine
Skelgon	Dragon	Zombie
Wow Warrior	Fish	Neptune
Griggle	Plant
Bone Mouse	Fiend Summon	Zombie
Frog The Jam	Aqua	Neptune
Behegon	Aqua	Neptune
Dark Elf	Dark Spellcaster	Female
Winged Dragon #2	Winged Beast
Mushroom Man #2	Warrior
Lava Battleguard	Shadow	Warrior
Tyhone #2	Dragon	Pyro
The Wandering Doomed	Fiend Summon	Zombie
Steel Ogre Grotto #1	Machine
Pot the Trick	Fiend Summon	Jar	Rock
Oscillo Hero	Warrior
Invader from Another Dimension	Fiend
Lesser Dragon	Dragon	Fiend Summon
Needle Worm	Insect
Wretched Ghost of the Attic	Fiend	Shadow
Great Mammoth of Goldfine
Man-eating Black Shark
Yormungarde	Neptune	Reptile
Darkworld Thorns	Plant
Anthrosaurus	Dinosaur
Drooling Lizard	Neptune	Reptile
Trakadon	Dinosaur
B. Dragon Jungle King	Dragon
Empress Judge	Warrior
Little D	Dinosaur
Witch of the Black Forest	Dark Spellcaster	Female	Shadow	Spellcaster
Ancient One of the Deep Forest	Animal	Beast
Giant Scorpion of the Tundra	Insect
Crow Goblin	Winged Beast
Leo Wizard	Dark Spellcaster	Shadow	Spellcaster
Abyss Flower	Plant
Patrol Robo	Machine
Takuhee	Feathered A	Feathered B	Winged Beast
Dark Witch	Feathered B	Female	Winged
Weather Report	Aqua	Neptune
Binding Chain	Fairy	Light
Mechanical Snail	Machine
Greenkappa	Fiend Summon	Warrior
Mon Larvas	Beast
Living Vase	Plant
Tentacle Plant	Plant
Beaked Snake	Neptune	Reptile
Morphing Jar	Jar	Rock
Muse-A	Fairy	Female	Light
Giant Turtle Who Feeds on Flames	Aqua	Neptune	Turtle
Rose Spectre of Dunn	Female	Plant
Fiend Refrection #1	Winged Beast
Ghoul with an Appetite	Zombie
Pale Beast	Animal	Beast
Little Chimera	Animal	Beast
Violent Rain	Aqua	Neptune
Key Mace #2	Female	Fiend	Shadow
Tenderness	Fairy	Feathered B	Light	Winged
Penguin Soldier	Aqua	Neptune
Fairy Dragon	Dragon
Obese Marmot of Nefariousness	Animal	Beast	Fiend Summon
Liquid Beast	Aqua	Neptune
Twin Long Rods #2	Aqua	Neptune
Great Bill	Beast
Shining Friendship	Fairy	Feathered B	Light	Winged
Bladefly	Insect
Electric Lizard	Thunder
Hiro's Shadow Scout	Fiend	Fiend Summon
Lady of Faith	Female	Light	Spellcaster
Twin-headed Thunder Dragon
Hunter Spider	Insect
Armored Starfish	Aqua	Neptune
Hourglass of Courage	Fairy	Feathered B	Light	Winged
Marine Beast	Fish	Neptune
Warrior of Tradition	Female	Shadow	Warrior
Rock Spirit	Spellcaster
Snakeyashi	Plant
Succubus Knight	Female	Shadow	Warrior
Ill Witch	Female	Light	Spellcaster
The Thing That Hides in the Mud	Rock
High Tide Gyojin	Aqua	Neptune
Fairy of the Fountain	Aqua	Female	Neptune
Amazon of the Seas	Female	Fish	Neptune
Nekogal #2	Female
Witch's Apprentice	Dark Spellcaster	Female	Shadow	Spellcaster	Winged
Armored Rat	Animal	Beast
Ancient Lizard Warrior	Neptune	Reptile
Maiden of the Moonlight	Feathered B	Female	Spellcaster	Winged
Stone Ogre Grotto	Rock
Winged Egg of New Life	Fairy	Feathered B	Light	Winged
Night Lizard	Aqua	Neptune
Queen's Double	Female	Warrior
Blue-winged Crown	Feathered A	Feathered B	Winged Beast
Trent	Plant
Queen of Autumn Leaves	Female	Plant
Amphibious Bugroth
Acid Crawler	Insect
Invader of the Throne	Female	Warrior
Mystical Sheep #1	Animal	Beast
Disk Magician	Machine
Flame Viper	Pyro
Royal Guard
Gruesome Goo	Aqua	Neptune
Hyosube	Aqua	Neptune
Machine Attacker	Machine
Hibikime	Female	Shadow	Warrior
Whiptail Crow	Fiend
Kunai with Chain
Magical Labyrinth	Harpie Killer
Warrior Elimination
Salamandra
Cursebreaker
Eternal Rest
Megamorph
Metalmorph
Winged Trumpeter	Feathered B
Stain Storm
Crush Card
Eradicating Aerosol
Breath of Light
Eternal Draught
Curse of Millennium Shield
Yamadron Ritual
Gate Guardian Ritual
Bright Castle
Shadow Spell
Black Luster Ritual
Zera Ritual
Harpie's Feather Duster
War-lion Ritual
Beastry Mirror Ritual
Ultimate Dragon
Commencement Dance
Hamburger Recipe
Revival of Sennen Genjin
Novox's Prayer
Curse of Tri-Horned Dragon
House of Adhesive Tape	Harpie Killer
Eatgaboon	Harpie Killer
Bear Trap	Harpie Killer
Invisible Wire	Harpie Killer
Acid Trap Hole
Widespread Ruin
Goblin Fan
Bad Reaction to Simochi
Reverse Trap
Fake Trap
Revived of Serpent Night Dragon
Turtle Oath
Contruct of Mask
Resurrection of Chakra
Puppet Ritual
Javelin Beetle Pact
Garma Sword Oath
Cosmo Queen's Prayer
Revival of Skeleton Rider
Fortress Whale's Oath
Performance of Sword	Warrior
Hungry Burger	Warrior
Sengenjin
Skull Guardian	Warrior
Tri-horned Dragon
Serpent Night Dragon	Dragon
Skull Knight
Cosmo Queen
Chakra	Fiend
Crab Turtle
Mikazukinoyaiba	Dragon
Meteor Dragon	Dragon
Meteor B. Dragon
Firewing Pegasus	Pyro
Psycho-Puppet	Fiend
Garma Sword
Javelin Beetle
Fortress Whale
Dokurorider	Zombie
Mask of Shine & Dark
Dark Magic Ritual
Magician of Black Chaos
